Country,Country Code,Exporter Degree,Importer Degree,Eigenvector Centrality In,Eigenvector Centrality Out,Closeness Centrality,Degree Centrality
China,156,495702,147070,0.0070623312976416264,0.006688177464802998,0.9336099585062241,642772
Germany,276,408040,191620,0.0071744341747524785,0.006766903757991244,0.9533898305084746,599660
Puerto Rico and US Virgin Islands,842,380344,187982,0.0071467243528644895,0.0067995326596715765,0.9698275862068966,568326
Monaco,251,344174,186884,0.007195517957144257,0.006908729046528734,1.0,531058
Netherlands,528,315298,203204,0.007197387032298923,0.006788854056550318,0.9615384615384616,518502
Italy,380,345539,153062,0.007182375731883642,0.006655242258346145,0.9146341463414634,498601
United Kingdom,826,318027,158870,0.007200760604505041,0.006841666881509284,0.974025974025974,476897
Spain,724,307728,152544,0.0071860278135229124,0.006872465862164124,0.9868421052631579,460272
India,699,289986,110313,0.007119645522740886,0.006708502663271859,0.9336099585062241,400299
Belgium,56,270049,128515,0.007179189360899816,0.006775946484083572,0.9615384615384616,398564
Turkey,792,253878,106963,0.007097573259058824,0.006748309799389422,0.9453781512605042,360841
Liechtenstein,757,195452,148415,0.00717248912533056,0.00651354507820854,0.8928571428571429,343867
Poland,616,208225,132274,0.0071498773489199864,0.006895520561760767,0.995575221238938,340499
Austria,40,202928,134715,0.007114083520652397,0.006799641430687134,0.9574468085106383,337643
Republic of Korea,410,193846,119839,0.007151123024051699,0.006856543385736765,0.9782608695652174,313685
Canada,124,157322,154792,0.007094767702212677,0.006773162023281235,0.9615384615384616,312114
Japan,392,196972,104374,0.007064307057764911,0.006692841983724825,0.9336099585062241,301346
Czechia,203,174816,125653,0.007065579480462587,0.006899584279524381,0.995575221238938,300469
Thailand,764,175658,115845,0.007180663821257177,0.00689321214585631,0.9911894273127754,291503
Denmark,208,175770,114532,0.007132595332503643,0.006527794755705272,0.896414342629482,290302
Sweden,752,168985,116505,0.007182625031631899,0.006823993823492533,0.9698275862068966,285490
not elsewhere specified,490,187632,91787,0.007079876309221055,0.006771638483257535,0.9493670886075949,279419
South Africa,710,143140,123644,0.007126046663053508,0.006866275026581007,0.9782608695652174,266784
Russian Federation,643,114344,128323,0.006794321714205414,0.006753741680046849,0.9453781512605042,242667
 Hong Kong SAR,344,142081,96152,0.006719737124230494,0.006360076543637096,0.8620689655172413,238233
Australia,36,123453,114735,0.00699856391336436,0.006739781738775101,0.9574468085106383,238188
Portugal,620,142416,88001,0.006997273152184231,0.006182504442161824,0.8333333333333334,230417
Hungary,348,121979,99348,0.006957979949591175,0.0059597236926011606,0.8035714285714286,221327
Malaysia,458,120422,93316,0.007106274681951485,0.006454121752463891,0.8823529411764706,213738
Finland,246,110136,102586,0.007031238056838239,0.006629230949324143,0.9146341463414634,212722
Indonesia,360,117781,91519,0.00705759682312896,0.0068077362665214265,0.9656652360515021,209300
Brazil,76,119992,86674,0.007066090508350791,0.006657677416601353,0.9336099585062241,206666
Romania,642,102863,102683,0.006781323772386205,0.006002570536322388,0.8064516129032258,205546
Slovenia,705,96899,96933,0.006808847998549631,0.006790688129802832,0.9615384615384616,193832
Svalbard and Jan Mayen,579,78769,112168,0.0069934368677210795,0.00650835136377908,0.8928571428571429,190937
Slovakia,703,88443,95564,0.006781356464019281,0.0068229883354204756,0.9782608695652174,184007
Greece,300,93006,87725,0.007046587478806951,0.006182775085357714,0.8395522388059702,180731
Lithuania,440,88260,84519,0.006801623288279682,0.005754632822993531,0.7731958762886598,172779
Bulgaria,100,87689,83258,0.006915569539543158,0.005859045314645037,0.7867132867132867,170947
Ireland,372,80276,88278,0.006943926057083898,0.006812038556465147,0.9698275862068966,168554
New Zealand,554,71203,92327,0.007025935561381927,0.006784868823982378,0.9615384615384616,163530
Singapore,702,82429,79708,0.00451321552976046,0.004349066320662054,0.6428571428571429,162137
United Arab Emirates,784,71096,90081,0.0044715869942631385,0.004309409692992012,0.6410256410256411,161177
Mexico,484,90399,66531,0.00451653788110327,0.004349066320662054,0.6428571428571429,156930
Israel,376,71099,80282,0.006393308235101146,0.005700419065408281,0.78125,151381
Serbia,688,56876,89499,0.00630962717888516,0.006521520976180322,0.907258064516129,146375
Viet Nam,704,81665,62140,0.004522940180093169,0.004349066320662054,0.6428571428571429,143805
Estonia,233,58518,85264,0.006534162450530822,0.006017296968391121,0.8093525179856115,143782
Croatia,191,63503,78613,0.006510296468653617,0.0056936902499973435,0.7731958762886598,142116
Latvia,428,61106,72967,0.006808794651298755,0.005516478912991374,0.75,134073
Chile,152,38778,87239,0.006645455871488539,0.006215536963796567,0.8490566037735849,126017
Colombia,170,47008,73885,0.006643175320132512,0.006447013528705341,0.8823529411764706,120893
Pakistan,586,55714,65145,0.006874220987733074,0.006655597874062161,0.9183673469387755,120859
Morocco,504,46766,70098,0.006524246093446822,0.0063404190926183565,0.8522727272727273,116864
Peru,604,40598,70819,0.00645800235949644,0.006430170020682959,0.8754863813229572,111417
Ukraine,804,45136,62453,0.004416091656205726,0.004321799692993852,0.635593220338983,107589
Sri Lanka,144,44863,62494,0.006771341078190372,0.006360685729410717,0.8687258687258688,107357
Luxembourg,442,41872,64435,0.004746495042746773,0.0064985076151453615,0.8928571428571429,106307
Panama,591,46860,58714,0.005392417456947413,0.004898050303387857,0.6859756097560976,105574
Lebanon,422,35188,68849,0.006426803924086674,0.006476649052186797,0.896414342629482,104037
Belarus,112,34503,67820,0.006309970459113838,0.006227377706714892,0.8458646616541353,102323
Costa Rica,188,29005,69489,0.006178646765887488,0.006403506092046926,0.8893280632411067,98494
Bosnia Herzegovina,70,27463,69996,0.005873137460048025,0.0064551134092819176,0.8858267716535433,97459
Kuwait,414,15533,80454,0.006019159608989387,0.006229149074187958,0.87890625,95987
Philippines,608,45381,50497,0.0044562453018356825,0.004316186786497974,0.6373937677053825,95878
Kazakhstan,398,20862,70212,0.005560254209641681,0.005852447901137119,0.8035714285714286,91074
Saudi Arabia,682,22830,62605,0.004425091611631421,0.004233415802100217,0.6392045454545454,85435
Dominican Republic,214,24178,61128,0.00593771163605222,0.006381516863189392,0.87890625,85306
Bahrain,48,14682,69701,0.005970463606673111,0.006478150502712246,0.9,84383
The Former Yugoslav Republic of Macedonia,807,21793,60911,0.0049290603543967965,0.005999038784008021,0.8152173913043478,82704
Egypt,818,34686,47733,0.004324429078145486,0.004316301631520584,0.6320224719101124,82419
Cyprus,196,21950,59577,0.006561716846620346,0.005917645441282759,0.78125,81527
Guatemala,320,27308,53961,0.005888211381978682,0.0053313204720462784,0.7328990228013029,81269
Iran,364,29192,51279,0.0057691646660407905,0.005019001207298114,0.6901840490797546,80471
Iceland,352,14001,65606,0.005765567410111624,0.005480753630064783,0.7450331125827815,79607
Argentina,32,33143,44852,0.004307400253807493,0.0042889201588297695,0.6284916201117319,77995
Ecuador,218,19067,57279,0.006232056858513597,0.006287507685765562,0.8687258687258688,76346
Georgia,268,16125,56542,0.0054181292921814325,0.005086606576637551,0.7053291536050157,72667
Oman,512,17517,54583,0.005914848600392205,0.005481882917883959,0.7401315789473685,72100
Mauritius,480,17850,52302,0.006090419552850307,0.00617857889880351,0.8364312267657993,70152
Malta,470,19002,50027,0.006241016253604523,0.005596675546069876,0.7450331125827815,69029
Jordan,400,18264,50197,0.006024049923399282,0.005510423203371743,0.75,68461
El Salvador,222,18007,50150,0.005452319440975249,0.005937444270596474,0.8152173913043478,68157
United Republic of Tanzania,834,12472,53336,0.005922353624388201,0.006154873721160533,0.8211678832116789,65808
Honduras,340,16127,49183,0.005450823575582581,0.006195421653026952,0.8490566037735849,65310
Uruguay,858,13048,50974,0.006044402895006431,0.005700816815909085,0.7627118644067796,64022
Algeria,12,5937,57924,0.005530611791174587,0.005972108811988459,0.8093525179856115,63861
Tunisia,788,26259,34673,0.004133321782995026,0.004184004824549546,0.6164383561643836,60932
Plurinational State of Bolivia,68,7267,51674,0.004997224859394061,0.00626166570813913,0.8653846153846154,58941
Nicaragua,558,10500,47919,0.005282280389804304,0.0061314800356515285,0.8272058823529411,58419
Bangladesh,50,26508,31700,0.004224347086984429,0.004316186786497974,0.6267409470752089,58208
Myanmar,104,17541,40617,0.00567013322915157,0.006188827843167539,0.8458646616541353,58158
Qatar,634,9247,48483,0.00420428502258526,0.004247695561513257,0.6267409470752089,57730
Montenegro,499,6215,49226,0.004380935141179181,0.005584231460929918,0.8152173913043478,55441
Cambodia,116,21501,31247,0.005575150030117043,0.005554640457207126,0.7211538461538461,52748
Armenia,51,7468,43701,0.005075621427155561,0.0057904250905878325,0.7839721254355401,51169
Paraguay,600,6283,40302,0.005583346589835337,0.005315301916186416,0.7352941176470589,46585
Madagascar,450,10748,35694,0.005916596155465134,0.005893074409746064,0.78125,46442
Namibia,516,15021,30180,0.0060587577371227636,0.0059271225856444695,0.800711743772242,45201
Nigeria,566,7669,36642,0.004282641619227729,0.004148044801307718,0.6320224719101124,44311
Maldives,462,1492,41086,0.00428949447348157,0.003919425663282993,0.677710843373494,42578
Kenya,404,10101,31345,0.004212456139604318,0.0042578003230781146,0.625,41446
Zambia,894,6257,34903,0.0050217701964706055,0.005617824567110138,0.8122743682310469,41160
Mongolia,496,5079,35787,0.004525261249272112,0.005334158316261404,0.7679180887372014,40866
Fiji,242,11422,28904,0.005204287280432103,0.004814545495464456,0.7550335570469798,40326
Brunei Darussalam,96,7188,32876,0.004507480472448048,0.005610705256410568,0.7758620689655172,40064
Albania,8,10950,28443,0.004076000345430054,0.004489811167732071,0.6428571428571429,39393
Republic of Moldova,498,9838,29413,0.0034543577875778843,0.003977306524752707,0.5936675461741425,39251
Ghana,288,6154,32751,0.004211896827388009,0.0040486649848696125,0.6232686980609419,38905
Kyrgyzstan,417,6257,29977,0.004427609133998817,0.004807987729444555,0.6987577639751553,36234
Sudan,729,2160,33910,0.005023409380269934,0.005766693119643997,0.8241758241758241,36070
Azerbaijan,31,4117,29614,0.0037464967549709722,0.0036110020118784282,0.6032171581769437,33731
Iraq,368,2497,31088,0.003898257018001698,0.003346285083584046,0.6147540983606558,33585
Macao Special Administrative Region,446,6300,26663,0.004497627428875962,0.005078643855145942,0.7120253164556962,32963
Angola,24,2800,29200,0.003900014919731771,0.0031506408260391656,0.6130790190735694,32000
Côte d'Ivoire,384,4722,25959,0.004069755739195606,0.004043722203308864,0.6198347107438017,30681
Burkina Faso,854,2695,27329,0.005057500656936607,0.005162016218008836,0.7679180887372014,30024
Venezuela,862,8548,21170,0.0039555247987341354,0.00408066713713026,0.6147540983606558,29718
Senegal,686,4167,25393,0.003993178923952557,0.004040770207613824,0.6130790190735694,29560
Uzbekistan,860,4500,24380,0.0031958192278690274,0.003622083848366947,0.5859375,28880
Cameroon,120,4549,20418,0.004024842307890771,0.004080626836467057,0.6164383561643836,24967
Ethiopia,231,4386,19943,0.0039352055407786525,0.004113296670805379,0.6147540983606558,24329
Mozambique,508,3296,19557,0.003739196278515371,0.0036029316990414018,0.6064690026954178,22853
Andorra,20,4790,18050,0.005141215276547634,0.005293232275745527,0.7281553398058253,22840
Swaziland,748,7688,14623,0.00504545047467286,0.00472624966928936,0.7009345794392523,22311
Cuba,192,1724,20265,0.0037799108636450704,0.004036089752430492,0.6016042780748663,21989
Lao People's Dem. Rep.,418,5546,16265,0.00422584099589498,0.004709741337771535,0.6521739130434783,21811
Nepal,524,8395,12954,0.0034104844411501343,0.003883493590614644,0.5936675461741425,21349
Trinidad and Tobago,780,2271,18455,0.003755679375834608,0.0038264604136993854,0.6064690026954178,20726
Democratic Republic of the Congo,180,1882,18828,0.0034437739685188053,0.0032176820196354815,0.5952380952380952,20710
Uganda,800,3341,16970,0.0037765481628454656,0.003972380673343726,0.6081081081081081,20311
Bermuda,60,1591,17768,0.0034088367762412667,0.005185356943187829,0.7377049180327869,19359
Guinea,324,1516,17034,0.0035303666047022853,0.003518108350215756,0.598404255319149,18550
Jamaica,388,2723,15734,0.003615409881002269,0.003935180620838721,0.6016042780748663,18457
Syria,760,5268,12984,0.0036980215041582222,0.0038278010253771735,0.6032171581769437,18252
Congo,178,1359,16652,0.0036096066523573643,0.0036328798290713336,0.6016042780748663,18011
Papua New Guinea,598,1463,15771,0.003000197894815362,0.003191068894416343,0.5798969072164949,17234
Mali,466,2021,15113,0.0035614673332246835,0.003796846297624684,0.5952380952380952,17134
Libya,434,1214,15486,0.0036798869010309693,0.003101027293485503,0.6048387096774194,16700
Turkmenistan,795,1272,15315,0.0028909970252951524,0.0033852481877120707,0.5754475703324808,16587
Gabon,266,1664,14864,0.0037933394006358367,0.003358298048833818,0.6048387096774194,16528
Seychelles,690,1431,15073,0.0035729279796614505,0.0037970688155000484,0.598404255319149,16504
New Caledonia,540,1393,15064,0.0031151272288496485,0.0029386167945680284,0.582901554404145,16457
Zimbabwe,716,3515,12814,0.003472963661086705,0.003729823424622971,0.5952380952380952,16329
Afghanistan,4,2955,13219,0.004205736310315204,0.003437658307399162,0.6064690026954178,16174
Haiti,332,2626,12985,0.0034633906819254855,0.003733869855903242,0.5952380952380952,15611
Botswana,72,4395,10910,0.0031890560918824635,0.003165041164161981,0.5859375,15305
Mauritania,478,1163,13799,0.003598616028468551,0.003582258132308185,0.6,14962
Togo,768,1568,12983,0.0037228335112468357,0.0030623566789414725,0.6032171581769437,14551
Greenland,304,1052,13424,0.0031729760210591736,0.004266020586629646,0.6944444444444444,14476
French Polynesia,258,1121,13352,0.0030016830341240567,0.0027118914384071818,0.5784061696658098,14473
Bahamas,44,1581,12787,0.0035162811309195673,0.003749390750673725,0.596816976127321,14368
Curaçao,531,1365,12720,0.0033261965552511485,0.0029191648545251006,0.5905511811023622,14085
Suriname,740,1826,11766,0.0034066166994405132,0.0034981112953252533,0.5936675461741425,13592
Sierra Leone,694,3380,9937,0.0037171991414824902,0.0036780955345379293,0.6064690026954178,13317
Tajikistan,762,1501,11472,0.003115142205264732,0.0033759093103940064,0.582901554404145,12973
Barbados,52,1436,11336,0.003222142946227294,0.003946541376195909,0.5859375,12772
Lesotho,426,3203,9365,0.0034324698212372926,0.0041448125555088085,0.6097560975609756,12568
Malawi,454,1583,10794,0.003310788138680008,0.003838701683702296,0.5905511811023622,12377
Liberia,430,663,11315,0.003680183249065385,0.0029057765431893144,0.6032171581769437,11978
Benin,204,1021,10825,0.0036452685804086882,0.0030979844153009462,0.6016042780748663,11846
Aruba,533,1487,10253,0.0030120558240795438,0.002387223725802748,0.5798969072164949,11740
Guyana,328,858,10348,0.003381126263221141,0.003330073313051496,0.587467362924282,11206
Yemen,887,950,10204,0.003559257510742002,0.0030035931297147647,0.598404255319149,11154
Djibouti,262,598,10358,0.0033946040825972865,0.00261800398642749,0.5921052631578947,10956
Rwanda,646,1015,9531,0.003299713086583911,0.003462730566546336,0.5921052631578947,10546
Gibraltar,292,1130,9403,0.002945295374456626,0.0029307772312881413,0.5769230769230769,10533
Equatorial Guinea,226,399,9744,0.0030047156900904126,0.002248646148999528,0.5784061696658098,10143
Belize,84,1949,7995,0.0034892550509762134,0.0037967803365562824,0.5952380952380952,9944
Cabo Verde,132,957,8779,0.0028527422527207208,0.002953067149598796,0.5725190839694656,9736
Democratic People's Republic of Korea,408,4474,4874,0.00276774205294921,0.003188675824203995,0.5754475703324808,9348
Gambia,270,722,8065,0.003372483923460271,0.0032389181343923323,0.5952380952380952,8787
Niger,562,1720,7018,0.0034338889941215546,0.003460389254494558,0.5890052356020943,8738
Somalia,706,549,7340,0.0032192566478817753,0.0029165509177850324,0.587467362924282,7889
Saint Lucia,662,724,6971,0.002825135402525465,0.0025600395499021412,0.5725190839694656,7695
Vanuatu,548,491,7022,0.002645282983433449,0.0025028587980547167,0.5667506297229219,7513
Antigua and Barbuda,28,801,6295,0.003155403876272729,0.003114151932981148,0.582901554404145,7096
Cayman Islands,136,794,5861,0.0030939340300831708,0.002586644724009326,0.582901554404145,6655
San Marino,674,2886,3654,0.002550865403450015,0.00340371648063244,0.5653266331658291,6540
Saint Maarten (Dutch part),534,464,6009,0.0020643847175303718,0.0014584945988041593,0.5501222493887531,6473
Samoa,882,745,5675,0.0021924697610105873,0.0021175387751583828,0.5541871921182266,6420
Chad,148,603,5787,0.003155089476594971,0.00323604553355288,0.5844155844155844,6390
Solomon Islands,90,493,5690,0.0021364683006008275,0.002412668608371735,0.5528255528255528,6183
Timor-Leste,626,335,5662,0.002008932700223628,0.0020459149389587435,0.5487804878048781,5997
State of Palestine,275,725,4794,0.0025689775235762445,0.002678518752686147,0.5653266331658291,5519
Grenada,308,466,4980,0.0030551558746100857,0.0026406612797461454,0.5798969072164949,5446
British Virgin Islands,92,1125,4199,0.0031581344246800346,0.0032706188816955255,0.5844155844155844,5324
Marshall Islands,584,563,4434,0.0026802262979342627,0.0026387370036737535,0.5681818181818182,4997
Central African Republic,140,649,4301,0.003067709226873498,0.0030370468080452486,0.5813953488372093,4950
Saint Vincent and the Grenadines,670,904,4043,0.0029057763778466503,0.0024044253072531656,0.5754475703324808,4947
Guam,316,454,4493,0.0025715163005654105,0.0020283408601099746,0.5653266331658291,4947
Tonga,776,406,4537,0.0016984827891597877,0.0018149816377118566,0.5408653846153846,4943
Dominica,212,812,3895,0.003138492573717064,0.0036043453655874857,0.5844155844155844,4707
Sao Tome and Principe,678,564,4125,0.0022835029924537435,0.0022653896040726188,0.5555555555555556,4689
Cook Islands,184,432,4209,0.002244206730243111,0.002164239387617114,0.5555555555555556,4641
Bhutan,64,437,4194,0.002295507613293154,0.0023838289068602264,0.556930693069307,4631
Burundi,108,398,4161,0.002719760268190163,0.0027503886596860093,0.569620253164557,4559
Comoros,174,499,3999,0.002648225114780108,0.003119974486580336,0.5681818181818182,4498
Saint Kitts and Nevis,659,525,3951,0.0028437318019603206,0.0029289262856145907,0.5739795918367347,4476
Guinea-Bissau,624,131,4083,0.0027583560662174625,0.0017343969805206066,0.5710659898477157,4214
Turks and Caicos Islands,796,605,3335,0.001959466447361071,0.0028814825368986357,0.5474452554744526,3940
Kiribati,296,299,3551,0.0018085152532089136,0.0019118545073933458,0.5434782608695652,3850
Eritrea,232,309,3227,0.0026490587503452488,0.002544025137323047,0.569620253164557,3536
Saint Barthélemy,652,447,2836,0.0011788709346717986,0.001442219719927074,0.5269320843091335,3283
Palau,585,121,2907,0.0020704963938944897,0.0016429655578519906,0.5501222493887531,3028
South Sudan,728,149,2746,0.0021936131324950116,0.001600013985304012,0.5541871921182266,2895
Saint Pierre and Miquelon,666,183,2676,0.0010319369463427435,0.001232890537557503,0.5232558139534884,2859
Saint Helena,654,436,2041,0.001363396734601049,0.0026343313302133165,0.5319148936170213,2477
Nauru,520,792,1667,0.0012143806549255517,0.0024641940378749864,0.528169014084507,2459
Federated State of Micronesia,583,101,2324,0.0015255722220343432,0.001323654024171987,0.5357142857142857,2425
American Samoa,16,755,1663,0.0019052043992767614,0.0027655186083769662,0.5447941888619855,2418
Saint Eustatius and Saba,535,120,2259,0.0013672983419933424,0.0006604281052577602,0.5319148936170213,2379
Northern Mariana Islands,580,130,1851,0.0019269303006328488,0.0016842951468704719,0.5461165048543689,1981
Wallis and Futuna Islands,876,158,1676,0.0015658262460095246,0.0015536070216374868,0.5369928400954654,1834
Anguilla,660,435,1377,0.002045921513304834,0.00249488985864288,0.5501222493887531,1812
Tuvalu,798,217,1575,0.00136260393600863,0.001905195735669517,0.5319148936170213,1792
Tokelau,772,1480,293,0.0011315983562259924,0.00290326814605273,0.5269320843091335,1773
Falkland Islands (Malvinas),238,252,1483,0.0016028363261738794,0.0020222142792133127,0.5382775119617225,1735
Niue,570,382,1245,0.000887233546994844,0.0020952726926643486,0.5208333333333334,1627
Christmas Islands,162,424,893,0.0006762748319739134,0.0022860707166412167,0.5160550458715596,1317
Norfolk Islands,574,87,1225,0.0008651644718282369,0.0011865444973628947,0.5196304849884527,1312
Montserrat,500,347,556,0.0015674060400742134,0.0021686549628764417,0.5369928400954654,903
British Indian Ocean Territories,86,238,609,0.0010085041963049863,0.00206561465035648,0.5232558139534884,847
French South Antarctic Territories,260,111,691,0.00147100168924366,0.0010594403383310164,0.5344418052256532,802
Cocos Islands,166,368,425,0.000809087256992332,0.0024407012565660366,0.5184331797235023,793
Pitcairn,612,179,140,0.00084755289816283,0.0018825111464624768,0.5196304849884527,319
